# ignore this line
# [texture][type][etc...]
size: 50 x 50
#
# 
| 0 | 0 | 0 | 0 | 4 | 5 | 6 | 7 | 8 | 9 | | 0 | 1 | 2 | 3 | 4 | 5 | 6 | 7 | 8 | 9 | | 0 | 1 | 2 | 3 | 4 | 5 | 6 | 7 | 8 | 9 | | 0 | 1 | 2 | 3 | 4 | 5 | 6 | 7 | 8 | 9 | | 0 | 1 | 2 | 3 | 4 | 5 | 6 | 7 | 8 | 9 | 
| 0 | 0 | 0 | 3 | 4 | 5 | 6 | 7 | 8 | 9 | | 0 | 1 | 2 | 3 | 4 | 5 | 6 | 7 | 8 | 9 | | 0 | 1 | 2 | 3 | 4 | 5 | 6 | 7 | 8 | 9 | | 0 | 1 | 2 | 3 | 4 | 5 | 6 | 7 | 8 | 9 | | 0 | 1 | 2 | 3 | 4 | 5 | 6 | 7 | 8 | 9 | 
| 0 | 0 | 0 | 3 | 4 | 5 | 6 | 7 | 8 | 9 | | 0 | 1 | 2 | 3 | 4 | 5 | 6 | 7 | 8 | 9 | | 0 | 1 | 2 | 3 | 4 | 5 | 6 | 7 | 8 | 9 | | 0 | 1 | 2 | 3 | 4 | 5 | 6 | 7 | 8 | 9 | | 0 | 1 | 2 | 3 | 4 | 5 | 6 | 7 | 8 | 9 | 
| 1 | 1 | 2 | 3 | 4 | 5 | 6 | 7 | 8 | 9 | | 0 | 1 | 2 | 3 | 4 | 5 | 6 | 7 | 8 | 9 | | 0 | 1 | 2 | 3 | 4 | 5 | 6 | 7 | 8 | 9 | | 0 | 1 | 2 | 3 | 4 | 5 | 6 | 7 | 8 | 9 | | 0 | 1 | 2 | 3 | 4 | 5 | 6 | 7 | 8 | 9 | 
| 1 | 1 | 2 | 3 | 4 | 5 | 6 | 7 | 8 | 9 | | 0 | 1 | 2 | 3 | 4 | 5 | 6 | 7 | 8 | 9 | | 0 | 1 | 2 | 3 | 4 | 5 | 6 | 7 | 8 | 9 | | 0 | 1 | 2 | 3 | 4 | 5 | 6 | 7 | 8 | 9 | | 0 | 1 | 2 | 3 | 4 | 5 | 6 | 7 | 8 | 9 | 
| 1 | 1 | 2 | 3 | 4 | 5 | 6 | 7 | 8 | 9 | | 0 | 1 | 2 | 3 | 4 | 5 | 6 | 7 | 8 | 9 | | 0 | 1 | 2 | 3 | 4 | 5 | 6 | 7 | 8 | 9 | | 0 | 1 | 2 | 3 | 4 | 5 | 6 | 7 | 8 | 9 | | 0 | 1 | 2 | 3 | 4 | 5 | 6 | 7 | 8 | 9 | 
| 1 | 1 | 2 | 3 | 4 | 5 | 6 | 7 | 8 | 9 | | 0 | 1 | 2 | 3 | 4 | 5 | 6 | 7 | 8 | 9 | | 0 | 1 | 2 | 3 | 4 | 5 | 6 | 7 | 8 | 9 | | 0 | 1 | 2 | 3 | 4 | 5 | 6 | 7 | 8 | 9 | | 0 | 1 | 2 | 3 | 4 | 5 | 6 | 7 | 8 | 9 | 
| 1 | 1 | 2 | 3 | 4 | 5 | 6 | 7 | 8 | 9 | | 0 | 1 | 2 | 3 | 4 | 5 | 6 | 7 | 8 | 9 | | 0 | 1 | 2 | 3 | 4 | 5 | 6 | 7 | 8 | 9 | | 0 | 1 | 2 | 3 | 4 | 5 | 6 | 7 | 8 | 9 | | 0 | 1 | 2 | 3 | 4 | 5 | 6 | 7 | 8 | 9 | 
| 1 | 1 | 2 | 3 | 4 | 5 | 6 | 7 | 8 | 9 | | 0 | 1 | 2 | 3 | 4 | 5 | 6 | 7 | 8 | 9 | | 0 | 1 | 2 | 3 | 4 | 5 | 6 | 7 | 8 | 9 | | 0 | 1 | 2 | 3 | 4 | 5 | 6 | 7 | 8 | 9 | | 0 | 1 | 2 | 3 | 4 | 5 | 6 | 7 | 8 | 9 | 
| 1 | 1 | 2 | 3 | 4 | 5 | 6 | 7 | 8 | 9 | | 0 | 1 | 2 | 3 | 4 | 5 | 6 | 7 | 8 | 9 | | 0 | 1 | 2 | 3 | 4 | 5 | 6 | 7 | 8 | 9 | | 0 | 1 | 2 | 3 | 4 | 5 | 6 | 7 | 8 | 9 | | 0 | 1 | 2 | 3 | 4 | 5 | 6 | 7 | 8 | 9 | 
| 1 | 1 | 2 | 3 | 4 | 5 | 6 | 7 | 8 | 9 | | 0 | 1 | 2 | 3 | 4 | 5 | 6 | 7 | 8 | 9 | | 0 | 1 | 2 | 3 | 4 | 5 | 6 | 7 | 8 | 9 | | 0 | 1 | 2 | 3 | 4 | 5 | 6 | 7 | 8 | 9 | | 0 | 1 | 2 | 3 | 4 | 5 | 6 | 7 | 8 | 9 | 
| 1 | 1 | 2 | 3 | 4 | 5 | 6 | 7 | 8 | 9 | | 0 | 1 | 2 | 3 | 4 | 5 | 6 | 7 | 8 | 9 | | 0 | 1 | 2 | 3 | 4 | 5 | 6 | 7 | 8 | 9 | | 0 | 1 | 2 | 3 | 4 | 5 | 6 | 7 | 8 | 9 | | 0 | 1 | 2 | 3 | 4 | 5 | 6 | 7 | 8 | 9 | 
| 1 | 1 | 2 | 3 | 4 | 5 | 6 | 7 | 8 | 9 | | 0 | 1 | 2 | 3 | 4 | 5 | 6 | 7 | 8 | 9 | | 0 | 1 | 2 | 3 | 4 | 5 | 6 | 7 | 8 | 9 | | 0 | 1 | 2 | 3 | 4 | 5 | 6 | 7 | 8 | 9 | | 0 | 1 | 2 | 3 | 4 | 5 | 6 | 7 | 8 | 9 | 
| 1 | 1 | 2 | 3 | 4 | 5 | 6 | 7 | 8 | 9 | | 0 | 1 | 2 | 3 | 4 | 5 | 6 | 7 | 8 | 9 | | 0 | 1 | 2 | 3 | 4 | 5 | 6 | 7 | 8 | 9 | | 0 | 1 | 2 | 3 | 4 | 5 | 6 | 7 | 8 | 9 | | 0 | 1 | 2 | 3 | 4 | 5 | 6 | 7 | 8 | 9 | 
| 1 | 1 | 2 | 3 | 4 | 5 | 6 | 7 | 8 | 9 | | 0 | 1 | 2 | 3 | 4 | 5 | 6 | 7 | 8 | 9 | | 0 | 1 | 2 | 3 | 4 | 5 | 6 | 7 | 8 | 9 | | 0 | 1 | 2 | 3 | 4 | 5 | 6 | 7 | 8 | 9 | | 0 | 1 | 2 | 3 | 4 | 5 | 6 | 7 | 8 | 9 | 
| 1 | 1 | 2 | 3 | 4 | 5 | 6 | 7 | 8 | 9 | | 0 | 1 | 2 | 3 | 4 | 5 | 6 | 7 | 8 | 9 | | 0 | 1 | 2 | 3 | 4 | 5 | 6 | 7 | 8 | 9 | | 0 | 1 | 2 | 3 | 4 | 5 | 6 | 7 | 8 | 9 | | 0 | 1 | 2 | 3 | 4 | 5 | 6 | 7 | 8 | 9 | 
| 1 | 1 | 2 | 3 | 4 | 5 | 6 | 7 | 8 | 9 | | 0 | 1 | 2 | 3 | 4 | 5 | 6 | 7 | 8 | 9 | | 0 | 1 | 2 | 3 | 4 | 5 | 6 | 7 | 8 | 9 | | 0 | 1 | 2 | 3 | 4 | 5 | 6 | 7 | 8 | 9 | | 0 | 1 | 2 | 3 | 4 | 5 | 6 | 7 | 8 | 9 | 
| 1 | 1 | 2 | 3 | 4 | 5 | 6 | 7 | 8 | 9 | | 0 | 1 | 2 | 3 | 4 | 5 | 6 | 7 | 8 | 9 | | 0 | 1 | 2 | 3 | 4 | 5 | 6 | 7 | 8 | 9 | | 0 | 1 | 2 | 3 | 4 | 5 | 6 | 7 | 8 | 9 | | 0 | 1 | 2 | 3 | 4 | 5 | 6 | 7 | 8 | 9 | 
| 1 | 1 | 2 | 3 | 4 | 5 | 6 | 7 | 8 | 9 | | 0 | 1 | 2 | 3 | 4 | 5 | 6 | 7 | 8 | 9 | | 0 | 1 | 2 | 3 | 4 | 5 | 6 | 7 | 8 | 9 | | 0 | 1 | 2 | 3 | 4 | 5 | 6 | 7 | 8 | 9 | | 0 | 1 | 2 | 3 | 4 | 5 | 6 | 7 | 8 | 9 | 
| 1 | 1 | 2 | 3 | 4 | 5 | 6 | 7 | 8 | 9 | | 0 | 1 | 2 | 3 | 4 | 5 | 6 | 7 | 8 | 9 | | 0 | 1 | 2 | 3 | 4 | 5 | 6 | 7 | 8 | 9 | | 0 | 1 | 2 | 3 | 4 | 5 | 6 | 7 | 8 | 9 | | 0 | 1 | 2 | 3 | 4 | 5 | 6 | 7 | 8 | 9 | 
| 1 | 1 | 2 | 3 | 4 | 5 | 6 | 7 | 8 | 9 | | 0 | 1 | 2 | 3 | 4 | 5 | 6 | 7 | 8 | 9 | | 0 | 1 | 2 | 3 | 4 | 5 | 6 | 7 | 8 | 9 | | 0 | 1 | 2 | 3 | 4 | 5 | 6 | 7 | 8 | 9 | | 0 | 1 | 2 | 3 | 4 | 5 | 6 | 7 | 8 | 9 | 
| 1 | 1 | 2 | 3 | 4 | 5 | 6 | 7 | 8 | 9 | | 0 | 1 | 2 | 3 | 4 | 5 | 6 | 7 | 8 | 9 | | 0 | 1 | 2 | 3 | 4 | 5 | 6 | 7 | 8 | 9 | | 0 | 1 | 2 | 3 | 4 | 5 | 6 | 7 | 8 | 9 | | 0 | 1 | 2 | 3 | 4 | 5 | 6 | 7 | 8 | 9 | 
| 1 | 1 | 2 | 3 | 4 | 5 | 6 | 7 | 8 | 9 | | 0 | 1 | 2 | 3 | 4 | 5 | 6 | 7 | 8 | 9 | | 0 | 1 | 2 | 3 | 4 | 5 | 6 | 7 | 8 | 9 | | 0 | 1 | 2 | 3 | 4 | 5 | 6 | 7 | 8 | 9 | | 0 | 1 | 2 | 3 | 4 | 5 | 6 | 7 | 8 | 9 | 
| 1 | 1 | 2 | 3 | 4 | 5 | 6 | 7 | 8 | 9 | | 0 | 1 | 2 | 3 | 4 | 5 | 6 | 7 | 8 | 9 | | 0 | 1 | 2 | 3 | 4 | 5 | 6 | 7 | 8 | 9 | | 0 | 1 | 2 | 3 | 4 | 5 | 6 | 7 | 8 | 9 | | 0 | 1 | 2 | 3 | 4 | 5 | 6 | 7 | 8 | 9 | 
| 1 | 1 | 2 | 3 | 4 | 5 | 6 | 7 | 8 | 9 | | 0 | 1 | 2 | 3 | 4 | 5 | 6 | 7 | 8 | 9 | | 0 | 1 | 2 | 3 | 4 | 5 | 6 | 7 | 8 | 9 | | 0 | 1 | 2 | 3 | 4 | 5 | 6 | 7 | 8 | 9 | | 0 | 1 | 2 | 3 | 4 | 5 | 6 | 7 | 8 | 9 | 
| 1 | 1 | 2 | 3 | 4 | 5 | 6 | 7 | 8 | 9 | | 0 | 1 | 2 | 3 | 4 | 5 | 6 | 7 | 8 | 9 | | 0 | 1 | 2 | 3 | 4 | 5 | 6 | 7 | 8 | 9 | | 0 | 1 | 2 | 3 | 4 | 5 | 6 | 7 | 8 | 9 | | 0 | 1 | 2 | 3 | 4 | 5 | 6 | 7 | 8 | 9 | 
| 1 | 1 | 2 | 3 | 4 | 5 | 6 | 7 | 8 | 9 | | 0 | 1 | 2 | 3 | 4 | 5 | 6 | 7 | 8 | 9 | | 0 | 1 | 2 | 3 | 4 | 5 | 6 | 7 | 8 | 9 | | 0 | 1 | 2 | 3 | 4 | 5 | 6 | 7 | 8 | 9 | | 0 | 1 | 2 | 3 | 4 | 5 | 6 | 7 | 8 | 9 | 
| 1 | 1 | 2 | 3 | 4 | 5 | 6 | 7 | 8 | 9 | | 0 | 1 | 2 | 3 | 4 | 5 | 6 | 7 | 8 | 9 | | 0 | 1 | 2 | 3 | 4 | 5 | 6 | 7 | 8 | 9 | | 0 | 1 | 2 | 3 | 4 | 5 | 6 | 7 | 8 | 9 | | 0 | 1 | 2 | 3 | 4 | 5 | 6 | 7 | 8 | 9 | 
| 1 | 1 | 2 | 3 | 4 | 5 | 6 | 7 | 8 | 9 | | 0 | 1 | 2 | 3 | 4 | 5 | 6 | 7 | 8 | 9 | | 0 | 1 | 2 | 3 | 4 | 5 | 6 | 7 | 8 | 9 | | 0 | 1 | 2 | 3 | 4 | 5 | 6 | 7 | 8 | 9 | | 0 | 1 | 2 | 3 | 4 | 5 | 6 | 7 | 8 | 9 | 
| 1 | 1 | 2 | 3 | 4 | 5 | 6 | 7 | 8 | 9 | | 0 | 1 | 2 | 3 | 4 | 5 | 6 | 7 | 8 | 9 | | 0 | 1 | 2 | 3 | 4 | 5 | 6 | 7 | 8 | 9 | | 0 | 1 | 2 | 3 | 4 | 5 | 6 | 7 | 8 | 9 | | 0 | 1 | 2 | 3 | 4 | 5 | 6 | 7 | 8 | 9 | 
| 1 | 1 | 2 | 3 | 4 | 5 | 6 | 7 | 8 | 9 | | 0 | 1 | 2 | 3 | 4 | 5 | 6 | 7 | 8 | 9 | | 0 | 1 | 2 | 3 | 4 | 5 | 6 | 7 | 8 | 9 | | 0 | 1 | 2 | 3 | 4 | 5 | 6 | 7 | 8 | 9 | | 0 | 1 | 2 | 3 | 4 | 5 | 6 | 7 | 8 | 9 | 
| 1 | 1 | 2 | 3 | 4 | 5 | 6 | 7 | 8 | 9 | | 0 | 1 | 2 | 3 | 4 | 5 | 6 | 7 | 8 | 9 | | 0 | 1 | 2 | 3 | 4 | 5 | 6 | 7 | 8 | 9 | | 0 | 1 | 2 | 3 | 4 | 5 | 6 | 7 | 8 | 9 | | 0 | 1 | 2 | 3 | 4 | 5 | 6 | 7 | 8 | 9 | 
| 1 | 1 | 2 | 3 | 4 | 5 | 6 | 7 | 8 | 9 | | 0 | 1 | 2 | 3 | 4 | 5 | 6 | 7 | 8 | 9 | | 0 | 1 | 2 | 3 | 4 | 5 | 6 | 7 | 8 | 9 | | 0 | 1 | 2 | 3 | 4 | 5 | 6 | 7 | 8 | 9 | | 0 | 1 | 2 | 3 | 4 | 5 | 6 | 7 | 8 | 9 | 
| 1 | 1 | 2 | 3 | 4 | 5 | 6 | 7 | 8 | 9 | | 0 | 1 | 2 | 3 | 4 | 5 | 6 | 7 | 8 | 9 | | 0 | 1 | 2 | 3 | 4 | 5 | 6 | 7 | 8 | 9 | | 0 | 1 | 2 | 3 | 4 | 5 | 6 | 7 | 8 | 9 | | 0 | 1 | 2 | 3 | 4 | 5 | 6 | 7 | 8 | 9 | 
| 1 | 1 | 2 | 3 | 4 | 5 | 6 | 7 | 8 | 9 | | 0 | 1 | 2 | 3 | 4 | 5 | 6 | 7 | 8 | 9 | | 0 | 1 | 2 | 3 | 4 | 5 | 6 | 7 | 8 | 9 | | 0 | 1 | 2 | 3 | 4 | 5 | 6 | 7 | 8 | 9 | | 0 | 1 | 2 | 3 | 4 | 5 | 6 | 7 | 8 | 9 | 
| 1 | 1 | 2 | 3 | 4 | 5 | 6 | 7 | 8 | 9 | | 0 | 1 | 2 | 3 | 4 | 5 | 6 | 7 | 8 | 9 | | 0 | 1 | 2 | 3 | 4 | 5 | 6 | 7 | 8 | 9 | | 0 | 1 | 2 | 3 | 4 | 5 | 6 | 7 | 8 | 9 | | 0 | 1 | 2 | 3 | 4 | 5 | 6 | 7 | 8 | 9 | 
| 1 | 1 | 2 | 3 | 4 | 5 | 6 | 7 | 8 | 9 | | 0 | 1 | 2 | 3 | 4 | 5 | 6 | 7 | 8 | 9 | | 0 | 1 | 2 | 3 | 4 | 5 | 6 | 7 | 8 | 9 | | 0 | 1 | 2 | 3 | 4 | 5 | 6 | 7 | 8 | 9 | | 0 | 1 | 2 | 3 | 4 | 5 | 6 | 7 | 8 | 9 | 
| 1 | 1 | 2 | 3 | 4 | 5 | 6 | 7 | 8 | 9 | | 0 | 1 | 2 | 3 | 4 | 5 | 6 | 7 | 8 | 9 | | 0 | 1 | 2 | 3 | 4 | 5 | 6 | 7 | 8 | 9 | | 0 | 1 | 2 | 3 | 4 | 5 | 6 | 7 | 8 | 9 | | 0 | 1 | 2 | 3 | 4 | 5 | 6 | 7 | 8 | 9 | 
| 1 | 1 | 2 | 3 | 4 | 5 | 6 | 7 | 8 | 9 | | 0 | 1 | 2 | 3 | 4 | 5 | 6 | 7 | 8 | 9 | | 0 | 1 | 2 | 3 | 4 | 5 | 6 | 7 | 8 | 9 | | 0 | 1 | 2 | 3 | 4 | 5 | 6 | 7 | 8 | 9 | | 0 | 1 | 2 | 3 | 4 | 5 | 6 | 7 | 8 | 9 | 
| 1 | 1 | 2 | 3 | 4 | 5 | 6 | 7 | 8 | 9 | | 0 | 1 | 2 | 3 | 4 | 5 | 6 | 7 | 8 | 9 | | 0 | 1 | 2 | 3 | 4 | 5 | 6 | 7 | 8 | 9 | | 0 | 1 | 2 | 3 | 4 | 5 | 6 | 7 | 8 | 9 | | 0 | 1 | 2 | 3 | 4 | 5 | 6 | 7 | 8 | 9 | 
| 1 | 1 | 2 | 3 | 4 | 5 | 6 | 7 | 8 | 9 | | 0 | 1 | 2 | 3 | 4 | 5 | 6 | 7 | 8 | 9 | | 0 | 1 | 2 | 3 | 4 | 5 | 6 | 7 | 8 | 9 | | 0 | 1 | 2 | 3 | 4 | 5 | 6 | 7 | 8 | 9 | | 0 | 1 | 2 | 3 | 4 | 5 | 6 | 7 | 8 | 9 | 
| 1 | 1 | 2 | 3 | 4 | 5 | 6 | 7 | 8 | 9 | | 0 | 1 | 2 | 3 | 4 | 5 | 6 | 7 | 8 | 9 | | 0 | 1 | 2 | 3 | 4 | 5 | 6 | 7 | 8 | 9 | | 0 | 1 | 2 | 3 | 4 | 5 | 6 | 7 | 8 | 9 | | 0 | 1 | 2 | 3 | 4 | 5 | 6 | 7 | 8 | 9 | 
| 1 | 1 | 2 | 3 | 4 | 5 | 6 | 7 | 8 | 9 | | 0 | 1 | 2 | 3 | 4 | 5 | 6 | 7 | 8 | 9 | | 0 | 1 | 2 | 3 | 4 | 5 | 6 | 7 | 8 | 9 | | 0 | 1 | 2 | 3 | 4 | 5 | 6 | 7 | 8 | 9 | | 0 | 1 | 2 | 3 | 4 | 5 | 6 | 7 | 8 | 9 | 
| 1 | 1 | 2 | 3 | 4 | 5 | 6 | 7 | 8 | 9 | | 0 | 1 | 2 | 3 | 4 | 5 | 6 | 7 | 8 | 9 | | 0 | 1 | 2 | 3 | 4 | 5 | 6 | 7 | 8 | 9 | | 0 | 1 | 2 | 3 | 4 | 5 | 6 | 7 | 8 | 9 | | 0 | 1 | 2 | 3 | 4 | 5 | 6 | 7 | 8 | 9 | 
| 1 | 1 | 2 | 3 | 4 | 5 | 6 | 7 | 8 | 9 | | 0 | 1 | 2 | 3 | 4 | 5 | 6 | 7 | 8 | 9 | | 0 | 1 | 2 | 3 | 4 | 5 | 6 | 7 | 8 | 9 | | 0 | 1 | 2 | 3 | 4 | 5 | 6 | 7 | 8 | 9 | | 0 | 1 | 2 | 3 | 4 | 5 | 6 | 7 | 8 | 9 | 
| 1 | 1 | 2 | 3 | 4 | 5 | 6 | 7 | 8 | 9 | | 0 | 1 | 2 | 3 | 4 | 5 | 6 | 7 | 8 | 9 | | 0 | 1 | 2 | 3 | 4 | 5 | 6 | 7 | 8 | 9 | | 0 | 1 | 2 | 3 | 4 | 5 | 6 | 7 | 8 | 9 | | 0 | 1 | 2 | 3 | 4 | 5 | 6 | 7 | 8 | 9 | 
| 1 | 1 | 2 | 3 | 4 | 5 | 6 | 7 | 8 | 9 | | 0 | 1 | 2 | 3 | 4 | 5 | 6 | 7 | 8 | 9 | | 0 | 1 | 2 | 3 | 4 | 5 | 6 | 7 | 8 | 9 | | 0 | 1 | 2 | 3 | 4 | 5 | 6 | 7 | 8 | 9 | | 0 | 1 | 2 | 3 | 4 | 5 | 6 | 7 | 8 | 9 | 
| 1 | 1 | 2 | 3 | 4 | 5 | 6 | 7 | 8 | 9 | | 0 | 1 | 2 | 3 | 4 | 5 | 6 | 7 | 8 | 9 | | 0 | 1 | 2 | 3 | 4 | 5 | 6 | 7 | 8 | 9 | | 0 | 1 | 2 | 3 | 4 | 5 | 6 | 7 | 8 | 9 | | 0 | 1 | 2 | 3 | 4 | 5 | 6 | 7 | 8 | 9 | 
| 1 | 1 | 2 | 3 | 4 | 5 | 6 | 7 | 8 | 9 | | 0 | 1 | 2 | 3 | 4 | 5 | 6 | 7 | 8 | 9 | | 0 | 1 | 2 | 3 | 4 | 5 | 6 | 7 | 8 | 9 | | 0 | 1 | 2 | 3 | 4 | 5 | 6 | 7 | 8 | 9 | | 0 | 1 | 2 | 3 | 4 | 5 | 6 | 7 | 8 | 9 | 
| 1 | 1 | 2 | 3 | 4 | 5 | 6 | 7 | 8 | 9 | | 0 | 1 | 2 | 3 | 4 | 5 | 6 | 7 | 8 | 9 | | 0 | 1 | 2 | 3 | 4 | 5 | 6 | 7 | 8 | 9 | | 0 | 1 | 2 | 3 | 4 | 5 | 6 | 7 | 8 | 9 | | 0 | 1 | 2 | 3 | 4 | 5 | 6 | 7 | 8 | 9 | 
#
#
| 0 | 1 | 2 | 3 | 4 | 5 | 6 | 7 | 8 | 9 | | 0 | 1 | 2 | 3 | 4 | 5 | 6 | 7 | 8 | 9 | | 0 | 1 | 2 | 3 | 4 | 5 | 6 | 7 | 8 | 9 | | 0 | 1 | 2 | 3 | 4 | 5 | 6 | 7 | 8 | 9 | | 0 | 1 | 2 | 3 | 4 | 5 | 6 | 7 | 8 | 9 | 
| 0 | 1 | 2 | 3 | 4 | 5 | 6 | 7 | 8 | 9 | | 0 | 1 | 2 | 3 | 4 | 5 | 6 | 7 | 8 | 9 | | 0 | 1 | 2 | 3 | 4 | 5 | 6 | 7 | 8 | 9 | | 0 | 1 | 2 | 3 | 4 | 5 | 6 | 7 | 8 | 9 | | 0 | 1 | 2 | 3 | 4 | 5 | 6 | 7 | 8 | 9 | 
| 0 | 1 | 2 | 3 | 4 | 5 | 6 | 7 | 8 | 9 | | 0 | 1 | 2 | 3 | 4 | 5 | 6 | 7 | 8 | 9 | | 0 | 1 | 2 | 3 | 4 | 5 | 6 | 7 | 8 | 9 | | 0 | 1 | 2 | 3 | 4 | 5 | 6 | 7 | 8 | 9 | | 0 | 1 | 2 | 3 | 4 | 5 | 6 | 7 | 8 | 9 | 
| 0 | 1 | 2 | 3 | 4 | 5 | 6 | 7 | 8 | 9 | | 0 | 1 | 2 | 3 | 4 | 5 | 6 | 7 | 8 | 9 | | 0 | 1 | 2 | 3 | 4 | 5 | 6 | 7 | 8 | 9 | | 0 | 1 | 2 | 3 | 4 | 5 | 6 | 7 | 8 | 9 | | 0 | 1 | 2 | 3 | 4 | 5 | 6 | 7 | 8 | 9 | 
| 0 | 1 | 2 | 3 | 4 | 5 | 6 | 7 | 8 | 9 | | 0 | 1 | 2 | 3 | 4 | 5 | 6 | 7 | 8 | 9 | | 0 | 1 | 2 | 3 | 4 | 5 | 6 | 7 | 8 | 9 | | 0 | 1 | 2 | 3 | 4 | 5 | 6 | 7 | 8 | 9 | | 0 | 1 | 2 | 3 | 4 | 5 | 6 | 7 | 8 | 9 | 
| 0 | 1 | 2 | 3 | 4 | 5 | 6 | 7 | 8 | 9 | | 0 | 1 | 2 | 3 | 4 | 5 | 6 | 7 | 8 | 9 | | 0 | 1 | 2 | 3 | 4 | 5 | 6 | 7 | 8 | 9 | | 0 | 1 | 2 | 3 | 4 | 5 | 6 | 7 | 8 | 9 | | 0 | 1 | 2 | 3 | 4 | 5 | 6 | 7 | 8 | 9 | 
| 0 | 1 | 2 | 3 | 4 | 5 | 6 | 7 | 8 | 9 | | 0 | 1 | 2 | 3 | 4 | 5 | 6 | 7 | 8 | 9 | | 0 | 1 | 2 | 3 | 4 | 5 | 6 | 7 | 8 | 9 | | 0 | 1 | 2 | 3 | 4 | 5 | 6 | 7 | 8 | 9 | | 0 | 1 | 2 | 3 | 4 | 5 | 6 | 7 | 8 | 9 | 
| 0 | 1 | 2 | 3 | 4 | 5 | 6 | 7 | 8 | 9 | | 0 | 1 | 2 | 3 | 4 | 5 | 6 | 7 | 8 | 9 | | 0 | 1 | 2 | 3 | 4 | 5 | 6 | 7 | 8 | 9 | | 0 | 1 | 2 | 3 | 4 | 5 | 6 | 7 | 8 | 9 | | 0 | 1 | 2 | 3 | 4 | 5 | 6 | 7 | 8 | 9 | 
| 0 | 1 | 2 | 3 | 4 | 5 | 6 | 7 | 8 | 9 | | 0 | 1 | 2 | 3 | 4 | 5 | 6 | 7 | 8 | 9 | | 0 | 1 | 2 | 3 | 4 | 5 | 6 | 7 | 8 | 9 | | 0 | 1 | 2 | 3 | 4 | 5 | 6 | 7 | 8 | 9 | | 0 | 1 | 2 | 3 | 4 | 5 | 6 | 7 | 8 | 9 | 
| 0 | 1 | 2 | 3 | 4 | 5 | 6 | 7 | 8 | 9 | | 0 | 1 | 2 | 3 | 4 | 5 | 6 | 7 | 8 | 9 | | 0 | 1 | 2 | 3 | 4 | 5 | 6 | 7 | 8 | 9 | | 0 | 1 | 2 | 3 | 4 | 5 | 6 | 7 | 8 | 9 | | 0 | 1 | 2 | 3 | 4 | 5 | 6 | 7 | 8 | 9 | 
| 0 | 1 | 2 | 3 | 4 | 5 | 6 | 7 | 8 | 9 | | 0 | 1 | 2 | 3 | 4 | 5 | 6 | 7 | 8 | 9 | | 0 | 1 | 2 | 3 | 4 | 5 | 6 | 7 | 8 | 9 | | 0 | 1 | 2 | 3 | 4 | 5 | 6 | 7 | 8 | 9 | | 0 | 1 | 2 | 3 | 4 | 5 | 6 | 7 | 8 | 9 | 
| 0 | 1 | 2 | 3 | 4 | 5 | 6 | 7 | 8 | 9 | | 0 | 1 | 2 | 3 | 4 | 5 | 6 | 7 | 8 | 9 | | 0 | 1 | 2 | 3 | 4 | 5 | 6 | 7 | 8 | 9 | | 0 | 1 | 2 | 3 | 4 | 5 | 6 | 7 | 8 | 9 | | 0 | 1 | 2 | 3 | 4 | 5 | 6 | 7 | 8 | 9 | 
| 0 | 1 | 2 | 3 | 4 | 5 | 6 | 7 | 8 | 9 | | 0 | 1 | 2 | 3 | 4 | 5 | 6 | 7 | 8 | 9 | | 0 | 1 | 2 | 3 | 4 | 5 | 6 | 7 | 8 | 9 | | 0 | 1 | 2 | 3 | 4 | 5 | 6 | 7 | 8 | 9 | | 0 | 1 | 2 | 3 | 4 | 5 | 6 | 7 | 8 | 9 | 
| 0 | 1 | 2 | 3 | 4 | 5 | 6 | 7 | 8 | 9 | | 0 | 1 | 2 | 3 | 4 | 5 | 6 | 7 | 8 | 9 | | 0 | 1 | 2 | 3 | 4 | 5 | 6 | 7 | 8 | 9 | | 0 | 1 | 2 | 3 | 4 | 5 | 6 | 7 | 8 | 9 | | 0 | 1 | 2 | 3 | 4 | 5 | 6 | 7 | 8 | 9 | 
| 0 | 1 | 2 | 3 | 4 | 5 | 6 | 7 | 8 | 9 | | 0 | 1 | 2 | 3 | 4 | 5 | 6 | 7 | 8 | 9 | | 0 | 1 | 2 | 3 | 4 | 5 | 6 | 7 | 8 | 9 | | 0 | 1 | 2 | 3 | 4 | 5 | 6 | 7 | 8 | 9 | | 0 | 1 | 2 | 3 | 4 | 5 | 6 | 7 | 8 | 9 | 
| 0 | 1 | 2 | 3 | 4 | 5 | 6 | 7 | 8 | 9 | | 0 | 1 | 2 | 3 | 4 | 5 | 6 | 7 | 8 | 9 | | 0 | 1 | 2 | 3 | 4 | 5 | 6 | 7 | 8 | 9 | | 0 | 1 | 2 | 3 | 4 | 5 | 6 | 7 | 8 | 9 | | 0 | 1 | 2 | 3 | 4 | 5 | 6 | 7 | 8 | 9 | 
| 0 | 1 | 2 | 3 | 4 | 5 | 6 | 7 | 8 | 9 | | 0 | 1 | 2 | 3 | 4 | 5 | 6 | 7 | 8 | 9 | | 0 | 1 | 2 | 3 | 4 | 5 | 6 | 7 | 8 | 9 | | 0 | 1 | 2 | 3 | 4 | 5 | 6 | 7 | 8 | 9 | | 0 | 1 | 2 | 3 | 4 | 5 | 6 | 7 | 8 | 9 | 
| 0 | 1 | 2 | 3 | 4 | 5 | 6 | 7 | 8 | 9 | | 0 | 1 | 2 | 3 | 4 | 5 | 6 | 7 | 8 | 9 | | 0 | 1 | 2 | 3 | 4 | 5 | 6 | 7 | 8 | 9 | | 0 | 1 | 2 | 3 | 4 | 5 | 6 | 7 | 8 | 9 | | 0 | 1 | 2 | 3 | 4 | 5 | 6 | 7 | 8 | 9 | 
| 0 | 1 | 2 | 3 | 4 | 5 | 6 | 7 | 8 | 9 | | 0 | 1 | 2 | 3 | 4 | 5 | 6 | 7 | 8 | 9 | | 0 | 1 | 2 | 3 | 4 | 5 | 6 | 7 | 8 | 9 | | 0 | 1 | 2 | 3 | 4 | 5 | 6 | 7 | 8 | 9 | | 0 | 1 | 2 | 3 | 4 | 5 | 6 | 7 | 8 | 9 | 
| 0 | 1 | 2 | 3 | 4 | 5 | 6 | 7 | 8 | 9 | | 0 | 1 | 2 | 3 | 4 | 5 | 6 | 7 | 8 | 9 | | 0 | 1 | 2 | 3 | 4 | 5 | 6 | 7 | 8 | 9 | | 0 | 1 | 2 | 3 | 4 | 5 | 6 | 7 | 8 | 9 | | 0 | 1 | 2 | 3 | 4 | 5 | 6 | 7 | 8 | 9 | 
| 0 | 1 | 2 | 3 | 4 | 5 | 6 | 7 | 8 | 9 | | 0 | 1 | 2 | 3 | 4 | 5 | 6 | 7 | 8 | 9 | | 0 | 1 | 2 | 3 | 4 | 5 | 6 | 7 | 8 | 9 | | 0 | 1 | 2 | 3 | 4 | 5 | 6 | 7 | 8 | 9 | | 0 | 1 | 2 | 3 | 4 | 5 | 6 | 7 | 8 | 9 | 
| 0 | 1 | 2 | 3 | 4 | 5 | 6 | 7 | 8 | 9 | | 0 | 1 | 2 | 3 | 4 | 5 | 6 | 7 | 8 | 9 | | 0 | 1 | 2 | 3 | 4 | 5 | 6 | 7 | 8 | 9 | | 0 | 1 | 2 | 3 | 4 | 5 | 6 | 7 | 8 | 9 | | 0 | 1 | 2 | 3 | 4 | 5 | 6 | 7 | 8 | 9 | 
| 0 | 1 | 2 | 3 | 4 | 5 | 6 | 7 | 8 | 9 | | 0 | 1 | 2 | 3 | 4 | 5 | 6 | 7 | 8 | 9 | | 0 | 1 | 2 | 3 | 4 | 5 | 6 | 7 | 8 | 9 | | 0 | 1 | 2 | 3 | 4 | 5 | 6 | 7 | 8 | 9 | | 0 | 1 | 2 | 3 | 4 | 5 | 6 | 7 | 8 | 9 | 
| 0 | 1 | 2 | 3 | 4 | 5 | 6 | 7 | 8 | 9 | | 0 | 1 | 2 | 3 | 4 | 5 | 6 | 7 | 8 | 9 | | 0 | 1 | 2 | 3 | 4 | 5 | 6 | 7 | 8 | 9 | | 0 | 1 | 2 | 3 | 4 | 5 | 6 | 7 | 8 | 9 | | 0 | 1 | 2 | 3 | 4 | 5 | 6 | 7 | 8 | 9 | 
| 0 | 1 | 2 | 3 | 4 | 5 | 6 | 7 | 8 | 9 | | 0 | 1 | 2 | 3 | 4 | 5 | 6 | 7 | 8 | 9 | | 0 | 1 | 2 | 3 | 4 | 5 | 6 | 7 | 8 | 9 | | 0 | 1 | 2 | 3 | 4 | 5 | 6 | 7 | 8 | 9 | | 0 | 1 | 2 | 3 | 4 | 5 | 6 | 7 | 8 | 9 | 
| 0 | 1 | 2 | 3 | 4 | 5 | 6 | 7 | 8 | 9 | | 0 | 1 | 2 | 3 | 4 | 5 | 6 | 7 | 8 | 9 | | 0 | 1 | 2 | 3 | 4 | 5 | 6 | 7 | 8 | 9 | | 0 | 1 | 2 | 3 | 4 | 5 | 6 | 7 | 8 | 9 | | 0 | 1 | 2 | 3 | 4 | 5 | 6 | 7 | 8 | 9 | 
| 0 | 1 | 2 | 3 | 4 | 5 | 6 | 7 | 8 | 9 | | 0 | 1 | 2 | 3 | 4 | 5 | 6 | 7 | 8 | 9 | | 0 | 1 | 2 | 3 | 4 | 5 | 6 | 7 | 8 | 9 | | 0 | 1 | 2 | 3 | 4 | 5 | 6 | 7 | 8 | 9 | | 0 | 1 | 2 | 3 | 4 | 5 | 6 | 7 | 8 | 9 | 
| 0 | 1 | 2 | 3 | 4 | 5 | 6 | 7 | 8 | 9 | | 0 | 1 | 2 | 3 | 4 | 5 | 6 | 7 | 8 | 9 | | 0 | 1 | 2 | 3 | 4 | 5 | 6 | 7 | 8 | 9 | | 0 | 1 | 2 | 3 | 4 | 5 | 6 | 7 | 8 | 9 | | 0 | 1 | 2 | 3 | 4 | 5 | 6 | 7 | 8 | 9 | 
| 0 | 1 | 2 | 3 | 4 | 5 | 6 | 7 | 8 | 9 | | 0 | 1 | 2 | 3 | 4 | 5 | 6 | 7 | 8 | 9 | | 0 | 1 | 2 | 3 | 4 | 5 | 6 | 7 | 8 | 9 | | 0 | 1 | 2 | 3 | 4 | 5 | 6 | 7 | 8 | 9 | | 0 | 1 | 2 | 3 | 4 | 5 | 6 | 7 | 8 | 9 | 
| 0 | 1 | 2 | 3 | 4 | 5 | 6 | 7 | 8 | 9 | | 0 | 1 | 2 | 3 | 4 | 5 | 6 | 7 | 8 | 9 | | 0 | 1 | 2 | 3 | 4 | 5 | 6 | 7 | 8 | 9 | | 0 | 1 | 2 | 3 | 4 | 5 | 6 | 7 | 8 | 9 | | 0 | 1 | 2 | 3 | 4 | 5 | 6 | 7 | 8 | 9 | 
| 0 | 1 | 2 | 3 | 4 | 5 | 6 | 7 | 8 | 9 | | 0 | 1 | 2 | 3 | 4 | 5 | 6 | 7 | 8 | 9 | | 0 | 1 | 2 | 3 | 4 | 5 | 6 | 7 | 8 | 9 | | 0 | 1 | 2 | 3 | 4 | 5 | 6 | 7 | 8 | 9 | | 0 | 1 | 2 | 3 | 4 | 5 | 6 | 7 | 8 | 9 | 
| 0 | 1 | 2 | 3 | 4 | 5 | 6 | 7 | 8 | 9 | | 0 | 1 | 2 | 3 | 4 | 5 | 6 | 7 | 8 | 9 | | 0 | 1 | 2 | 3 | 4 | 5 | 6 | 7 | 8 | 9 | | 0 | 1 | 2 | 3 | 4 | 5 | 6 | 7 | 8 | 9 | | 0 | 1 | 2 | 3 | 4 | 5 | 6 | 7 | 8 | 9 | 
| 0 | 1 | 2 | 3 | 4 | 5 | 6 | 7 | 8 | 9 | | 0 | 1 | 2 | 3 | 4 | 5 | 6 | 7 | 8 | 9 | | 0 | 1 | 2 | 3 | 4 | 5 | 6 | 7 | 8 | 9 | | 0 | 1 | 2 | 3 | 4 | 5 | 6 | 7 | 8 | 9 | | 0 | 1 | 2 | 3 | 4 | 5 | 6 | 7 | 8 | 9 | 
| 0 | 1 | 2 | 3 | 4 | 5 | 6 | 7 | 8 | 9 | | 0 | 1 | 2 | 3 | 4 | 5 | 6 | 7 | 8 | 9 | | 0 | 1 | 2 | 3 | 4 | 5 | 6 | 7 | 8 | 9 | | 0 | 1 | 2 | 3 | 4 | 5 | 6 | 7 | 8 | 9 | | 0 | 1 | 2 | 3 | 4 | 5 | 6 | 7 | 8 | 9 | 
| 0 | 1 | 2 | 3 | 4 | 5 | 6 | 7 | 8 | 9 | | 0 | 1 | 2 | 3 | 4 | 5 | 6 | 7 | 8 | 9 | | 0 | 1 | 2 | 3 | 4 | 5 | 6 | 7 | 8 | 9 | | 0 | 1 | 2 | 3 | 4 | 5 | 6 | 7 | 8 | 9 | | 0 | 1 | 2 | 3 | 4 | 5 | 6 | 7 | 8 | 9 | 
| 0 | 1 | 2 | 3 | 4 | 5 | 6 | 7 | 8 | 9 | | 0 | 1 | 2 | 3 | 4 | 5 | 6 | 7 | 8 | 9 | | 0 | 1 | 2 | 3 | 4 | 5 | 6 | 7 | 8 | 9 | | 0 | 1 | 2 | 3 | 4 | 5 | 6 | 7 | 8 | 9 | | 0 | 1 | 2 | 3 | 4 | 5 | 6 | 7 | 8 | 9 | 
| 0 | 1 | 2 | 3 | 4 | 5 | 6 | 7 | 8 | 9 | | 0 | 1 | 2 | 3 | 4 | 5 | 6 | 7 | 8 | 9 | | 0 | 1 | 2 | 3 | 4 | 5 | 6 | 7 | 8 | 9 | | 0 | 1 | 2 | 3 | 4 | 5 | 6 | 7 | 8 | 9 | | 0 | 1 | 2 | 3 | 4 | 5 | 6 | 7 | 8 | 9 | 
| 0 | 1 | 2 | 3 | 4 | 5 | 6 | 7 | 8 | 9 | | 0 | 1 | 2 | 3 | 4 | 5 | 6 | 7 | 8 | 9 | | 0 | 1 | 2 | 3 | 4 | 5 | 6 | 7 | 8 | 9 | | 0 | 1 | 2 | 3 | 4 | 5 | 6 | 7 | 8 | 9 | | 0 | 1 | 2 | 3 | 4 | 5 | 6 | 7 | 8 | 9 | 
| 0 | 1 | 2 | 3 | 4 | 5 | 6 | 7 | 8 | 9 | | 0 | 1 | 2 | 3 | 4 | 5 | 6 | 7 | 8 | 9 | | 0 | 1 | 2 | 3 | 4 | 5 | 6 | 7 | 8 | 9 | | 0 | 1 | 2 | 3 | 4 | 5 | 6 | 7 | 8 | 9 | | 0 | 1 | 2 | 3 | 4 | 5 | 6 | 7 | 8 | 9 | 
| 0 | 1 | 2 | 3 | 4 | 5 | 6 | 7 | 8 | 9 | | 0 | 1 | 2 | 3 | 4 | 5 | 6 | 7 | 8 | 9 | | 0 | 1 | 2 | 3 | 4 | 5 | 6 | 7 | 8 | 9 | | 0 | 1 | 2 | 3 | 4 | 5 | 6 | 7 | 8 | 9 | | 0 | 1 | 2 | 3 | 4 | 5 | 6 | 7 | 8 | 9 | 
| 0 | 1 | 2 | 3 | 4 | 5 | 6 | 7 | 8 | 9 | | 0 | 1 | 2 | 3 | 4 | 5 | 6 | 7 | 8 | 9 | | 0 | 1 | 2 | 3 | 4 | 5 | 6 | 7 | 8 | 9 | | 0 | 1 | 2 | 3 | 4 | 5 | 6 | 7 | 8 | 9 | | 0 | 1 | 2 | 3 | 4 | 5 | 6 | 7 | 8 | 9 | 
| 0 | 1 | 2 | 3 | 4 | 5 | 6 | 7 | 8 | 9 | | 0 | 1 | 2 | 3 | 4 | 5 | 6 | 7 | 8 | 9 | | 0 | 1 | 2 | 3 | 4 | 5 | 6 | 7 | 8 | 9 | | 0 | 1 | 2 | 3 | 4 | 5 | 6 | 7 | 8 | 9 | | 0 | 1 | 2 | 3 | 4 | 5 | 6 | 7 | 8 | 9 | 
| 0 | 1 | 2 | 3 | 4 | 5 | 6 | 7 | 8 | 9 | | 0 | 1 | 2 | 3 | 4 | 5 | 6 | 7 | 8 | 9 | | 0 | 1 | 2 | 3 | 4 | 5 | 6 | 7 | 8 | 9 | | 0 | 1 | 2 | 3 | 4 | 5 | 6 | 7 | 8 | 9 | | 0 | 1 | 2 | 3 | 4 | 5 | 6 | 7 | 8 | 9 | 
| 0 | 1 | 2 | 3 | 4 | 5 | 6 | 7 | 8 | 9 | | 0 | 1 | 2 | 3 | 4 | 5 | 6 | 7 | 8 | 9 | | 0 | 1 | 2 | 3 | 4 | 5 | 6 | 7 | 8 | 9 | | 0 | 1 | 2 | 3 | 4 | 5 | 6 | 7 | 8 | 9 | | 0 | 1 | 2 | 3 | 4 | 5 | 6 | 7 | 8 | 9 | 
| 0 | 1 | 2 | 3 | 4 | 5 | 6 | 7 | 8 | 9 | | 0 | 1 | 2 | 3 | 4 | 5 | 6 | 7 | 8 | 9 | | 0 | 1 | 2 | 3 | 4 | 5 | 6 | 7 | 8 | 9 | | 0 | 1 | 2 | 3 | 4 | 5 | 6 | 7 | 8 | 9 | | 0 | 1 | 2 | 3 | 4 | 5 | 6 | 7 | 8 | 9 | 
| 0 | 1 | 2 | 3 | 4 | 5 | 6 | 7 | 8 | 9 | | 0 | 1 | 2 | 3 | 4 | 5 | 6 | 7 | 8 | 9 | | 0 | 1 | 2 | 3 | 4 | 5 | 6 | 7 | 8 | 9 | | 0 | 1 | 2 | 3 | 4 | 5 | 6 | 7 | 8 | 9 | | 0 | 1 | 2 | 3 | 4 | 5 | 6 | 7 | 8 | 9 | 
| 0 | 1 | 2 | 3 | 4 | 5 | 6 | 7 | 8 | 9 | | 0 | 1 | 2 | 3 | 4 | 5 | 6 | 7 | 8 | 9 | | 0 | 1 | 2 | 3 | 4 | 5 | 6 | 7 | 8 | 9 | | 0 | 1 | 2 | 3 | 4 | 5 | 6 | 7 | 8 | 9 | | 0 | 1 | 2 | 3 | 4 | 5 | 6 | 7 | 8 | 9 | 
| 0 | 1 | 2 | 3 | 4 | 5 | 6 | 7 | 8 | 9 | | 0 | 1 | 2 | 3 | 4 | 5 | 6 | 7 | 8 | 9 | | 0 | 1 | 2 | 3 | 4 | 5 | 6 | 7 | 8 | 9 | | 0 | 1 | 2 | 3 | 4 | 5 | 6 | 7 | 8 | 9 | | 0 | 1 | 2 | 3 | 4 | 5 | 6 | 7 | 8 | 9 | 
| 0 | 1 | 2 | 3 | 4 | 5 | 6 | 7 | 8 | 9 | | 0 | 1 | 2 | 3 | 4 | 5 | 6 | 7 | 8 | 9 | | 0 | 1 | 2 | 3 | 4 | 5 | 6 | 7 | 8 | 9 | | 0 | 1 | 2 | 3 | 4 | 5 | 6 | 7 | 8 | 9 | | 0 | 1 | 2 | 3 | 4 | 5 | 6 | 7 | 8 | 9 | 
| 0 | 1 | 2 | 3 | 4 | 5 | 6 | 7 | 8 | 9 | | 0 | 1 | 2 | 3 | 4 | 5 | 6 | 7 | 8 | 9 | | 0 | 1 | 2 | 3 | 4 | 5 | 6 | 7 | 8 | 9 | | 0 | 1 | 2 | 3 | 4 | 5 | 6 | 7 | 8 | 9 | | 0 | 1 | 2 | 3 | 4 | 5 | 6 | 7 | 8 | 9 | 